1111111111111111111111111111111111
1000000000000000000000000000000001
1E0000000000D00C00000C000000000001
10100101001000D0101001000000010101
1010010010101010001001000000010101
1P0000000C00C000000D000000000000C1
1000000000000000000000000000000001
1000000000000000000000000000000001
1111111111111111111111111111111111